9-to-Midnight
An Interactive Fiction by Evan Thomson
Release 1 / Serial number 171208 / Inform 7 build 6M62 (I6/v6.33 lib 6/12N) SD

Your Room
Posters of all your favorite anime cover the walls. In one corner is a bookshelf holding your collection of authentic Japanese Mangas, with action figures covering the top surface. Your RGB gaming machine sits on your desk, with mouse and keyboard setup perfectly in front of it. Your door is on the south end of your room, with Sword Art Online poster hanging on it. From downstairs you can hear people chattering, and the thumping of some shitty pop music.  Your roomate Chad is throwing another frat party.

You can see your door, an Asuna body pillow and a Katana here.

>x sel
You can't see any such thing.

>x self
As good-looking as ever.

>x the player
You can't see any such thing.

>x jeremy
You can't see any such thing.

>x man
You can't see any such thing.

>x Jeremy
You can't see any such thing.

>x self
As good-looking as ever.

>north
You can't go that way.

>south
You can't go that way.

>east
You can't go that way.

>west
You can't go that way.

* * *

>south
(first opening your door)

>north
You can't go that way.

>south
Upstairs Hallway
You can see Jeremys door here.

>north
Your Room
You can see Jeremys door, an Asuna Body Pillow and a Katana here.

* * *

>north
You can't go that way.

>ne
Your Room
Posters of all your favorite anime cover the walls. In one corner is a bookshelf holding your collection of authentic Japanese Mangas, with action figures covering the top surface.

You can see your door, an Asuna body pillow and a Katana here.

>close door
You close your door.

>open door
You open your door.

* * *

I beg your pardon?

I beg your pardon?

* * *

>south
(first opening your door)

>take stairs
You can't see any such thing.

>close staircase
You close the main staircase.

>northeast
Your Room
You can see your door, an Asuna body pillow, a Katana and your computer here.

>south
Upstairs Hallway
You can see your door, Other roomates door, Chads door, Upstairs bathroom door and a main staircase here.

>enter room
You can't see any such thing.

>enter your room
You can't see any such thing.

>enter bathroom
(first opening Upstairs bathroom door)

Upstairs bathroom
You can see Upstairs bathroom door here.

>exit
But you aren't in anything at the moment.

>exit bathroom
I only understood you as far as wanting to exit.

>south
Upstairs Hallway
You can see Upstairs bathroom door, your door, Other roomates door, Chads door and a main staircase here.

>enter your door
You can't see any such thing.

>open your door
You can't see any such thing.

>close your door
You can't see any such thing.

>northeast
Your Room
You can see your door, an Asuna body pillow, a Katana and your computer here.

>use computer
That's not a verb I recognise.

* * *

>south
(first opening your door)

>down
There is far too many people for this house in the downstairs. You could hear the ruckus they were making from upstairs, but now the music is really pounding your ear drums.

>take stairs
You can't see any such thing.

>use stairs
I didn't understand that sentence.

>up
Upstairs Hallway
You can see a main staircase, your door, Other roomates door, Chads door and Upstairs bathroom door here.

* * *

>down
There is far too many people for this house in the downstairs. You could hear the ruckus they were making from upstairs, but now the music is really pounding your ear drums.

>east
Kitchen
In the kitchen you find a couple bowls of Jungle Juice. AKA very alcoholic and very tasty mixed drinks. Cups are nearby so you could serve yourself some. There are also cans of beer nearby but you have more class than that don't you? Some other people are hanging in here strategically placed to grab drinks at will.

You can see Jungle Juice, Jess and a frat guy here.

>drink jungle juice
you pour your self a cup, and down it. Its strong, but not too bad of a flavor.

>drink
What do you want to drink?

>drink jungle juice
There's nothing suitable to drink here.

>eat jungle juice
(first taking Jungle Juice)
You eat Jungle Juice. Not bad.

* * *

>down
There is far too many people for this house in the downstairs. You could hear the ruckus they were making from upstairs, but now the music is really pounding your ear drums.

>z
Time passes.

>z
Time passes.

>z
Time passes.

someone has your body pillow.

>z
Time passes.

* * *

>z
Time passes.

someone has your body pillow.

>z
Time passes.

someone has your body pillow.

* * *

>z
Time passes.

>play vidya
You load up Sakura Agent to try to finish your play through. The story was really getting good when you last left off

>z
Time passes.

I beg your pardon?

>z
Time passes.

>z
Time passes.

You suddenly hear your dumbass roomate Chad yell from the upstairs balcony "Yo Dudes! Look what I found!"
He's waving Ms. Asuna's body over the balcony while everyone jeers and laughs. They must have grabbed it while you went downstairs. One of his friends has your katana, and is brandishing it at Asuna in a frightening manner.
In a rage, you run up the stairs, pushing past drunk party goers and spilling drinks. As you reach the balcony at the end of the hall, you see the two preparing to slice Asuna in half.

>z
Time passes.

>punch chad
You charge forward, and swing your fist with all your might at chads face. Lucky for him, he manages to duck away just in time or he would have been decimated. By the time you recoil your punch,  the guy with your katana grabs you from behind, and Chad punches you in the stomach. With your quick thinking, you realize there's two options, kick the friend in the nuts or try to wriggle free.

>kick friend
You launch your hardest heel kick you can straight into the asshole's groin. He doubles over, releasing you and dropping the katana. The katana bounces once on the balcony railing, and flies over the edge. It falls and lands straight in the head of one of the party goers.

>wriggle free
As Chad comes in for another punch, you drop low, and try to pull free from the mongrel behind you. Chad wasn't expecting this, and his punch connects with his asshole friend's abs, forcing him to double over. In his pain he loses grip of the katana, dropping it. The katana bounces once on the balcony railing, and flies over the edge. It falls and lands straight in the head of one of the party goers.

* * *

>down
There is far too many people for this house in the downstairs. You could hear the ruckus they were making from upstairs, but now the music is really pounding your ear drums.

>play vidya
You load up Sakura Agent to try to finish your play through. The story was really getting good when you last left off

* * *

>z
Time passes.

>z
Time passes.

pillow sequenceupper floor

>z
Time passes.

* * *

>down
There is far too many people for this house in the downstairs. You could hear the ruckus they were making from upstairs, but now the music is really pounding your ear drums.

>vidya
That's not a verb I recognise.

>asdoifja;oidjf;ali
That's not a verb I recognise.

>play vidya
You load up Sakura Agent to try to finish your play through. The story was really getting good when you last left off

* * *

>z
Time passes.

>z
Time passes.

pillow sequencelower floor

* * *

>down
There is far too many people for this house in the downstairs. You could hear the ruckus they were making from upstairs, but now the music is really pounding your ear drums.

>south
Upstairs bathroom
You manage to slip into the bathroom as someone else is leaving. It's barely 9:02 pm, and the bathroom is already a wreck. Why can't anyone clean up after themselves.

You can see Upstairs bathroom door here.

* * *

>east
Kitchen
In the kitchen you find a couple bowls of punch or other presumably alcoholic drinks. There's cups nearby for people to serve themselves There are also cans of beer nearby but beers are so cliche. A few people you've never seen before are hanging out in the kitchen, presumably to be closer to the alcohol.

You can see Punch, Jess and a frat guy here.

* * *

>down
There is far too many people for this house in the downstairs. You could hear the ruckus they were making from upstairs, but now the music is really pounding your ear drums.

>ask josh about chad
Chad's cool. We have a couple classes together.

>ask josh about inuyasha
No ablo espanolo

>ask josh about video games
Yea man, I play a little League now and then.

>z
Time passes.

>east
Kitchen
In the kitchen you find a couple bowls of punch or other presumably alcoholic drinks. There's cups nearby for people to serve themselves There are also cans of beer nearby but beers are so cliche. A few people you've never seen before are hanging out in the kitchen, presumably to be closer to the alcohol.

You can see Punch, Jess and a frat guy here.

>kitchen
That's not a verb I recognise.

>drink punch
You must supply a noun.

>take punch
Taken.

>drink punch
You must supply a noun.

>take frat guy
I don't suppose the frat guy would care for that.

>drink punch
You must supply a noun.

* * *

>south
(first opening your door)

I beg your pardon?

>east
You can't go that way.

* * *

I beg your pardon?

>north
You can't go that way.

>northeast
Your Room
Posters of all your favorite anime cover the walls. In one corner is a bookshelf holding your collection of authentic Japanese Mangas, with action figures covering the top surface.

You can see your door, an Asuna body pillow and a Katana here.

* * *

>down
There is far too many people for this house in the downstairs. You could hear the ruckus they were making from upstairs, but now the music is really pounding your ear drums.

* * *

>southeast
(first opening Other roomates door)
It seems to be locked.

>southwest
(first opening Chads door)
It seems to be locked.

>northwest
(first opening Upstairs bathroom door)

Upstairs bathroom
You manage to slip into the bathroom as someone else is leaving. It's barely 9:08 pm, and the bathroom is already a wreck. Why can't anyone clean up after themselves.

You can see Upstairs bathroom door here.

* * *

>south
(first opening your door)

>northwest
(first opening Upstairs bathroom door)

Upstairs bathroom
You can see Upstairs bathroom door here.

* * *

>south
(first opening your door)

>d
There is far too many people for this house in the downstairs. You could hear the ruckus they were making from upstairs, but now the music is really pounding your ear drums.

>x
What do you want to examine?

>x self
You are Jeremy, a 3rd year in college. A bit overweight, but your beard is coming in nicely and you dress sharply.

>south
downstairs bathroom
You manage to slip into the bathroom as someone else is leaving. It's barely 9:03 pm, and the bathroom is already a wreck. Why can't anyone clean up after themselves.

* * *

>ask josh about chad
Chad's cool. We have a couple classes together.

>ask josh about party
I wasn't gonna come, but I though I'd just show up and see whats happening.

>ask josh about anime
I watched DBZ when I was a kid, that shit was dope.

>ask josh about dbz
Don't tell anyone else here or they'll think I'm a nerd, but I've seen every episode.

>ask josh about league
I'm pretty good actually, I just hit gold the other day.

>ask jess about chad
You can't see any such thing.

>eastt
That's not a verb I recognise.

>e
Kitchen
In the kitchen you find a couple bowls of punch or other presumably alcoholic drinks. There's cups nearby for people to serve themselves There are also cans of beer nearby but beers are so cliche. A few people you've never seen before are hanging out in the kitchen, presumably to be closer to the alcohol.

You can see Punch, Jess and a frat guy here.

>ask jess about chad
Chad's so cool. He's always able to hook me and my friends up with alcohol.

>ask jess about alcohol
Have you tried the punch yet? Its a good mix, and STRONG, too.

* * *

>open door
You open your door.

>south
Upstairs Hallway
You can see your door, Other roomates door, Chads door, Upstairs bathroom door and a staircase here.

>open bathroom door
You open Upstairs bathroom door.

>enter bathroom
Upstairs bathroom
You can see Upstairs bathroom door here.

>south
Upstairs Hallway
You can see Upstairs bathroom door, your door, Other roomates door, Chads door and a staircase here.

>south
You can't go that way.

>southwest
(first opening Chads door)

Chads room
You can see Chads door here.

* * *

>use computer
You sit down at your desk, and turn your computer on. Your desktop pic is the beatiful Asuna. But should you watch the latest episode of "Nanatsu no Taizai: Imashime no Fukkatsu" or play some vidya?

>you use computer
That's not a verb I recognise.

>use computer
That's not a verb I recognise.

>south
(first opening your door)

Upstairs Hallway
You can see your door, Other roomates door, Chads door, Upstairs bathroom door and a main staircase here.

>north
You can't go that way.

>northeast
Your Room
You can see your door, an Asuna body pillow, a Katana and your computer here.

* * *

>use computer
You sit down at your desk, and turn your computer on. Your desktop pic is the beatiful Asuna. But should you watch the latest episode of "Nanatsu no Taizai: Imashime no Fukkatsu" or play some vidya?

>nigger
That's not a verb I recognise.

>fuck you
That's not a verb I recognise.

>;asidjf;alidjf;laisjfliaejf;liawje;fliawejf;aliwejf;awlekfj;alwijef
That's not a verb I recognise.

* * *

>play some vidya
You load up Sakura Agent to try to finish your play through. The story was really getting good when you last left off

>use computer
You sit down at your desk, and turn your computer on. Your desktop pic is the beatiful Asuna. But should you watch the latest episode of "Nanatsu no Taizai: Imashime no Fukkatsu" or play some vidya?

>play some vidya
That's not a verb I recognise.

* * *

>play some vidya
You load up Sakura Agent to try to finish your play through. The story was really getting good when you last left off

>play vidya
I didn't understand that sentence.

>play video games
I didn't understand that sentence.

>play some vidya games
I didn't understand that sentence.

* * *

>play vidya
You load up Sakura Agent to try to finish your play through. The story was really getting good when you last left off
They slice Asuna in half, and feathers burst out fluttering around the room. Through the mass of feathers you can see the katana fly out of the drunken oaf's hand, fliping above the crowd for a brief moment before falling down directly into the skull of one of the party goers.

You can hear Chad yelling as he slides down the balcony into the living room.

>play some vidya
You load up Sakura Agent to try to finish your play through. The story was really getting good when you last left off

>play some video games
You load up Sakura Agent to try to finish your play through. The story was really getting good when you last left off

* * *

>play vidya
You load up Sakura Agent to try to finish your play through. The story was really getting good when you last left off
They slice Asuna in half, and feathers burst out fluttering around the room. Through the mass of feathers you can see the katana fly out of the drunken oaf's hand, fliping above the crowd for a brief moment before falling down directly into the skull of one of the party goers.

You can hear Chad yelling as he slides down the balcony into the living room.

>s
(first opening your door)

Upstairs Hall
In the big hallway outside your room, there's already a number of people upstiars chatting. You don't know any of them, are hesitant to strike up a conversation. At the east end of the hallway is the balcony overlooking the living room on the floor below. On the northwest side of the hallway is the door to your bathroom, and on the northeast side is the door back to the sanctuary of your room. Southeast and southwest of the hallway are doors to Chad and your other housemate's rooms. At the other end of the hallway there are stairs leading down to the living room.

You can see your door, Other roomates door, Chads door, Upstairs bathroom door and a main staircase here.

They slice Asuna in half, and feathers burst out fluttering around the room. Through the mass of feathers you can see the katana fly out of the drunken oaf's hand, fliping above the crowd for a brief moment before falling down directly into the skull of one of the party goers.

>d
living room
You enter the living room. There is a kitchen to the east and a bathroom to the south. There are also stairs going to the second floor to the west.

You can see a main staircase, Chad, a table, Jen and Josh here.

There is far too many people for this house in the downstairs. You could hear the ruckus they were making from upstairs, but now the music is really pounding your ear drums.

They slice Asuna in half, and feathers burst out fluttering around the room. Through the mass of feathers you can see the katana fly out of the drunken oaf's hand, fliping above the crowd for a brief moment before falling down directly into the skull of one of the party goers.

* * *

>swing katana
You give your katana a couple of practice swings. While the others are out socializing, you study the blade.

* * *

>z
Time passes.

>s
(first opening your door)

Upstairs Hall
In the big hallway outside your room, there's already a number of people upstiars chatting. You don't know any of them, are hesitant to strike up a conversation. At the east end of the hallway is the balcony overlooking the living room on the floor below. On the northwest side of the hallway is the door to your bathroom, and on the northeast side is the door back to the sanctuary of your room. Southeast and southwest of the hallway are doors to Chad and your other housemate's rooms. At the other end of the hallway there are stairs leading down to the living room.

You can see your door, Other roomates door, Chads door, Upstairs bathroom door and a main staircase here.

>d
living room
You enter the living room. There is a kitchen to the east and a bathroom to the south. There are also stairs going to the second floor to the west.

You can see a main staircase, a table, Jen and Josh here.

There is far too many people for this house in the downstairs. You could hear the ruckus they were making from upstairs, but now the music is really pounding your ear drums.

>play vidya
You load up Sakura Agent to try to finish your play through. The story was really getting good when you last left off
You can hear Chad yelling as he slides down the balcony into the living room.

>z
Time passes.

>z
Time passes.

You suddenly hear your dumbass roomate Chad yell from the upstairs balcony "Yo Dudes! Look what I found!"
He's waving Ms. Asuna's body over the balcony while everyone jeers and laughs. They must have grabbed it while you went downstairs. One of his friends has your katana, and is brandishing it at Asuna in a frightening manner.
In a rage, you run up the stairs, pushing past drunk party goers and spilling drinks. As you reach the balcony at the end of the hall, you see the two preparing to slice Asuna in half.

Upstairs Hall
 CHAAAAAAAAAAAAAAAAAAD 

You can see a main staircase, your door, Other roomates door, Chads door and Upstairs bathroom door here.

>z
Time passes.

9:52 pm, 9:53 pm.
They slice Asuna in half, and feathers burst out fluttering around the room. Through the mass of feathers you can see the katana fly out of the drunken oaf's hand, fliping above the crowd for a brief moment before falling down directly into the skull of one of the party goers.

* * *

>punch chad
You charge forward, and swing your fist with all your might at chads face. Lucky for him, he manages to duck away just in time or he would have been decimated. By the time you recoil your punch,  the guy with your katana grabs you from behind, and Chad punches you in the stomach. With your quick thinking, you realize there's two options, kick the friend in the nuts or try to wriggle free.

9:52 pm, 9:53 pm.
They slice Asuna in half, and feathers burst out fluttering around the room. Through the mass of feathers you can see the katana fly out of the drunken oaf's hand, fliping above the crowd for a brief moment before falling down directly into the skull of one of the party goers.

>lk;asjdf
That's not a verb I recognise.

>kijas
That's not a verb I recognise.

>kasf
That's not a verb I recognise.

>jkasd
That's not a verb I recognise.

>jka
That's not a verb I recognise.

>jkia
That's not a verb I recognise.

>restart
Are you sure you want to restart?

>y
9-to-Midnight
An Interactive Fiction by Evan Thomson
Release 1 / Serial number 171207 / Inform 7 build 6M62 (I6/v6.33 lib 6/12N) SD

Your Room
Posters of all your favorite anime cover the walls. In one corner is a bookshelf holding your collection of authentic Japanese Mangas, with action figures covering the top surface. Your RGB gaming machine sits on your desk, with mouse and keyboard setup perfectly in front of it. Your door is on the south end of your room, with Sword Art Online poster hanging on it. From downstairs you can hear people chattering, and the thumping of some shitty pop music.  Your roomate Chad is throwing another frat party.

You can see your door, an Asuna body pillow and a Katana here.

>punch chad
That wouldn't be good for roomate relations.

>examine pillow
You see nothing special about the Asuna body pillow.

>examine katana
it's an authentic Hanzo sword from the early 16th century, folded over 1000 times by master craftsmen until the perfect composition was reached.

I beg your pardon?

* * *

>z
Time passes.

>use computer
You sit down at your desk, and turn your computer on. Your desktop pic is the beatiful Asuna. But should you watch the latest episode of "Nanatsu no Taizai: Imashime no Fukkatsu" or play some vidya?

* * *

>x self
You are Jeremy, a 3rd year in college. A bit overweight, but your beard is coming in nicely and you dress sharply.

>x yourself
You can't see any such thing.

>x self
As good-looking as ever.

>examine self
As good-looking as ever.

>examine yourself
You can't see any such thing.

* * *

>take katana
Probably shouldn't bring the katana out to the party.

>take computer
Taken.

>take body pillow
Taken.

>z
Time passes.

>play some vidya
You load up Sakura Agent to try to finish your play through. The story was really getting good when you last left off

>play some vidya
You load up Sakura Agent to try to finish your play through. The story was really getting good when you last left off

I beg your pardon?

>play some vidya
You load up Sakura Agent to try to finish your play through. The story was really getting good when you last left off

>sleep
You aren't feeling especially drowsy.

>watch anime
You can't see any such thing.

>watch anime
You can't see any such thing.

>watch latest
You can't see any such thing.

>anime
That's not a verb I recognise.

>watch anime
You can't see any such thing.

>use computer
You sit down at your desk, and turn your computer on. Your desktop pic is the beatiful Asuna. But should you watch the latest episode of "Nanatsu no Taizai: Imashime no Fukkatsu" or play some vidya?

>watch anime
You can't see any such thing.

* * *

>take katana
Probably shouldn't bring the katana out to the party.

>take pillow
Taken.

>south
(first opening your door)

Upstairs Hall
In the big hallway outside your room, there's already a number of people upstiars chatting. You don't know any of them, are hesitant to strike up a conversation. At the east end of the hallway is the balcony overlooking the living room on the floor below. On the northwest side of the hallway is the door to your bathroom, and on the northeast side is the door back to the sanctuary of your room. Southeast and southwest of the hallway are doors to Chad and your other housemate's rooms. At the other end of the hallway there are stairs leading down to the living room.

You can see your door, Other roomates door, Chads door, Upstairs bathroom door, a main staircase, Move the player and Move Chad here.

>move chad
Move Chad might not like that.

>asld;kfja
That's not a verb I recognise.

>examine me
You are Jeremy, a 3rd year in college. A bit overweight, but your beard is coming in nicely and you dress sharply.

>use computer
You sit down at your desk, and turn your computer on. Your desktop pic is the beatiful Asuna. But should you watch the latest episode of "Nanatsu no Taizai: Imashime no Fukkatsu" or play some vidya?

>play some vidya
You load up Sakura Agent to try to finish your play through. The story was really getting good when you last left off
You can hear Chad yelling as he slides down the balcony into the living room.

* * *

>take stairs
You can't see any such thing.

>south
(first opening your door)

Upstairs Hallway
You can see your door, Other roomates door, Chads door, Upstairs bathroom door and a main staircase here.

>take stairs
You can't see any such thing.

>take staircase
That's fixed in place.

>descend
That's not a verb I recognise.

>down
living room
You enter the living room. There were people standing out front chatting and drinking. That was a good sign that this was going to be a big party. As you enter, you immediately notice a lot of people occupying the space. Not just on the first floor either. You can see there are a number of people on the balcony up the stairs as well. You recognize some of the people in here. There is a kitchen to the east and a bathroom to the south. There are also stairs going to the second floor to the west

You can see a main staircase, Jen and a table here.

>up
Upstairs Hallway
You can see a main staircase, your door, Other roomates door, Chads door and Upstairs bathroom door here.

>close stair
You can't see any such thing.

>close staircase
It isn't something you can close.

* * *

>x katana
it's an authentic Hanzo sword from the early 16th century, folded over 1000 times by master craftsmen until the perfect composition was reached.

>z
Time passes.

* * *

>i hate chickens
I only understood you as far as wanting to take inventory.

>i
You are carrying nothing.

>take katana
Probably shouldn't bring the katana out to the party.

>x katana
it's an authentic Hanzo sword from the early 16th century, folded over 1000 times by master craftsmen until the perfect composition was reached.

>south
(first opening your door)

Upstairs Hall
In the big hallway outside your room, there's already a number of people upstiars chatting. You don't know any of them, are hesitant to strike up a conversation. At the east end of the hallway is the balcony overlooking the living room on the floor below. On the northwest side of the hallway is the door to your bathroom, and on the northeast side is the door back to the sactuary of your room. Southeast and southwest of the hallway are doors to Chad and your other housemate's rooms. At the other end of the hallway there are stairs leading down to the living room.

You can see your door here.

>north
You can't go that way.

* * *

>northeast
Your Room
Posters of all your favorite anime cover the walls. In one corner is a bookshelf holding your collection of authentic Japanese Mangas, with action figures covering the top surface.

You can see your door, an Asuna body pillow and a Katana here.

>exit
But you aren't in anything at the moment.

>south
Upstairs Hall
In the big hallway outside your room, there's already a number of people upstiars chatting. You don't know any of them, are hesitant to strike up a conversation. At the east end of the hallway is the balcony overlooking the living room on the floor below. On the northwest side of the hallway is the door to your bathroom, and on the northeast side is the door back to the sactuary of your room. Southeast and southwest of the hallway are doors to Chad and your other housemate's rooms. At the other end of the hallway there are stairs leading down to the living room.

You can see your door here.

>play vidya
You load up Sakura Agent to try to finish your play through. The story was really getting good when you last left off

>use computer
You sit down at your desk, and turn your computer on. Your desktop pic is the beatiful Asuna. But should you watch the latest episode of "Nanatsu no Taizai: Imashime no Fukkatsu" or play some vidya?

>south
You can't go that way.

>southeast
You can't go that way.

>southwest
You can't go that way.

>northwest
You can't go that way.

>northeast
Your Room
Posters of all your favorite anime cover the walls. In one corner is a bookshelf holding your collection of authentic Japanese Mangas, with action figures covering the top surface.

You can see your door, an Asuna body pillow and a Katana here.

>south
Upstairs Hall
In the big hallway outside your room, there's already a number of people upstiars chatting. You don't know any of them, are hesitant to strike up a conversation. At the east end of the hallway is the balcony overlooking the living room on the floor below. On the northwest side of the hallway is the door to your bathroom, and on the northeast side is the door back to the sactuary of your room. Southeast and southwest of the hallway are doors to Chad and your other housemate's rooms. At the other end of the hallway there are stairs leading down to the living room.

You can see your door here.

>northwest
You can't go that way.

* * *

>south
You can't go that way.

>west
You can't go that way.

>east
You can't go that way.

>down
You can't go that way.

>down
You can't go that way.

>restart
Are you sure you want to restart?

>y
9-to-Midnight
An Interactive Fiction by Evan Thomson
Release 1 / Serial number 171206 / Inform 7 build 6M62 (I6/v6.33 lib 6/12N) SD

Your Room
Posters of all your favorite anime cover the walls. In one corner is a bookshelf holding your collection of authentic Japanese Mangas, with action figures covering the top surface.

You can see your door, an Asuna body pillow and a Katana here.

>south
(first opening your door)

Upstairs Hall
In the big hallway outside your room, there's already a number of people upstiars chatting. You don't know any of them, are hesitant to strike up a conversation. At the east end of the hallway is the balcony overlooking the living room on the floor below. On the northwest side of the hallway is the door to your bathroom, and on the northeast side is the door back to the sactuary of your room. Southeast and southwest of the hallway are doors to Chad and your other housemate's rooms. At the other end of the hallway there are stairs leading down to the living room.

You can see your door here.

>northwest
You can't go that way.

>nw
You can't go that way.

>ne
Your Room
Posters of all your favorite anime cover the walls. In one corner is a bookshelf holding your collection of authentic Japanese Mangas, with action figures covering the top surface.

You can see your door, an Asuna body pillow and a Katana here.

>s
Upstairs Hall
In the big hallway outside your room, there's already a number of people upstiars chatting. You don't know any of them, are hesitant to strike up a conversation. At the east end of the hallway is the balcony overlooking the living room on the floor below. On the northwest side of the hallway is the door to your bathroom, and on the northeast side is the door back to the sactuary of your room. Southeast and southwest of the hallway are doors to Chad and your other housemate's rooms. At the other end of the hallway there are stairs leading down to the living room.

You can see your door here.

>down
You can't go that way.

>r
That's not a verb I recognise.

>restart
Are you sure you want to restart?

* * *

>y
9-to-Midnight
An Interactive Fiction by Evan Thomson
Release 1 / Serial number 171206 / Inform 7 build 6M62 (I6/v6.33 lib 6/12N) SD

Your Room
Posters of all your favorite anime cover the walls. In one corner is a bookshelf holding your collection of authentic Japanese Mangas, with action figures covering the top surface.

You can see your door, an Asuna body pillow and a Katana here.

>s
(first opening your door)

Upstairs Hall
In the big hallway outside your room, there's already a number of people upstiars chatting. You don't know any of them, are hesitant to strike up a conversation. At the east end of the hallway is the balcony overlooking the living room on the floor below. On the northwest side of the hallway is the door to your bathroom, and on the northeast side is the door back to the sactuary of your room. Southeast and southwest of the hallway are doors to Chad and your other housemate's rooms. At the other end of the hallway there are stairs leading down to the living room.

You can see your door here.

>down
You can't go that way.

>take stairs
You can't see any such thing.

* * *

>s
(first opening your door)

Upstairs Hall
In the big hallway outside your room, there's already a number of people upstiars chatting. You don't know any of them, are hesitant to strike up a conversation. At the east end of the hallway is the balcony overlooking the living room on the floor below. On the northwest side of the hallway is the door to your bathroom, and on the northeast side is the door back to the sanctuary of your room. Southeast and southwest of the hallway are doors to Chad and your other housemate's rooms. At the other end of the hallway there are stairs leading down to the living room.

You can see your door, Other roomates door, Chads door, Upstairs bathroom door and a main staircase here.

They slice Asuna in half, and feathers burst out fluttering around the room. Through the mass of feathers you can see the katana fly out of the drunken oaf's hand, fliping above the crowd for a brief moment before falling down directly into the skull of one of the party goers.

>ne
Your Room
Posters of all your favorite anime cover the walls. In one corner is a bookshelf holding your collection of authentic Japanese Mangas, with action figures covering the top surface.

You can see your door, an Asuna body pillow and a Katana here.

* * *

>nw
(first opening Upstairs bathroom door)

Upstairs bathroom
You can see Upstairs bathroom door here.

* * *

>x room
You can't see any such thing.

>x
What do you want to examine?

>x self
As good-looking as ever.

* * *

>d
living room
You enter the living room. There is a kitchen to the east and a bathroom to the south. There are also stairs going to the second floor to the west.

You can see a main staircase, a table, Jen and Josh here.

There is far too many people for this house in the downstairs. You could hear the ruckus they were making from upstairs, but now the music is really pounding your ear drums.

They slice Asuna in half, and feathers burst out fluttering around the room. Through the mass of feathers you can see the katana fly out of the drunken oaf's hand, fliping above the crowd for a brief moment before falling down directly into the skull of one of the party goers.

>e
Kitchen
In the kitchen you find a couple bowls of punch or other presumably alcoholic drinks. There's cups nearby for people to serve themselves There are also cans of beer nearby but beers are so cliche. A few people you've never seen before are hanging out in the kitchen, presumably to be closer to the alcohol.

You can see Fruit Punch, Jess and a frat guy here.

>drunk punch
That's not a verb I recognise.

>drink punch
You pour your self a cup, and down it. Its strong, and the flavor is awful. But if you're gonna talk to people, you'll need some alcohol in your system. People generally like you a lot more when your drunk.

* * *

>z
Time passes.

They slice Asuna in half, and feathers burst out fluttering around the room. Through the mass of feathers you can see the katana fly out of the drunken oaf's hand, fliping above the crowd for a brief moment before falling down directly into the skull of one of the party goers.

I beg your pardon?

* * *

>z
Time passes.

>look
living room
You enter the living room. There is a kitchen to the east and a bathroom to the south. There are also stairs going to the second floor to the west.

You can see Chad, a main staircase, a table, Jen and Josh here.

* * *

>z
Time passes.

They slice Asuna in half, and feathers burst out fluttering around the room. Through the mass of feathers you can see the katana fly out of the drunken oaf's hand, fliping above the crowd for a brief moment before falling down directly into the skull of one of the party goers.

>z
Time passes.

They slice Asuna in half, and feathers burst out fluttering around the room. Through the mass of feathers you can see the katana fly out of the drunken oaf's hand, fliping above the crowd for a brief moment before falling down directly into the skull of one of the party goers.

* * *

>x door
You can't see any such thing.

>x gon give it to ya
You can't see any such thing.

>a
That's not a verb I recognise.

>a
That's not a verb I recognise.

>z
Time passes.

* * *

I beg your pardon?

>z
Time passes.

You can hear Chad yelling as he slides down the balcony into the living room.

>z
Time passes.

* * *

I beg your pardon?

>zz
That's not a verb I recognise.

>z
Time passes.

>z
Time passes.

You suddenly hear your dumbass roomate Chad yell from the upstairs balcony "Yo Dudes! Look what I found!"
He's waving Ms. Asuna's body over the balcony while everyone jeers and laughs. They must have grabbed it while you went downstairs. One of his friends has your katana, and is brandishing it at Asuna in a frightening manner.
In a rage, you run up the stairs, pushing past drunk party goers and spilling drinks. As you reach the balcony at the end of the hall, you see the two preparing to slice Asuna in half.

Upstairs Hall
In the big hallway outside your room, there's already a number of people upstiars chatting. You don't know any of them, are hesitant to strike up a conversation. At the east end of the hallway is the balcony overlooking the living room on the floor below. On the northwest side of the hallway is the door to your bathroom, and on the northeast side is the door back to the sanctuary of your room. Southeast and southwest of the hallway are doors to Chad and your other housemate's rooms. At the other end of the hallway there are stairs leading down to the living room.

You can see a main staircase, your door, Other roomates door, Chads door and Upstairs bathroom door here.

* * *

>play vidya
You load up Sakura Agent to try to finish your play through. The story was really getting good when you last left off
You can hear Chad yelling as he slides down the balcony into the living room.

>play vidya
You load up Sakura Agent to try to finish your play through. The story was really getting good when you last left off

* * *

>z
Time passes.

>restart
Are you sure you want to restart?

* * *

>s
(first opening your door)

Upstairs Hall
In the big hallway outside your room, there's already a number of people upstiars chatting. You don't know any of them, are hesitant to strike up a conversation. At the east end of the hallway is the balcony overlooking the living room on the floor below. On the northwest side of the hallway is the door to your bathroom, and on the northeast side is the door back to the sanctuary of your room. Southeast and southwest of the hallway are doors to Chad and your other housemate's rooms. At the other end of the hallway there are stairs leading down to the living room.

You can see your door, Other roomates door, Chads door, Upstairs bathroom door and a main staircase here.

* * *

>z
Time passes.

>z
Time passes.

You suddenly hear your dumbass roomate Chad yell from the upstairs balcony "Yo Dudes! Look what I found!"
He's waving Ms. Asuna's body over the balcony while everyone jeers and laughs. They must have grabbed it while you went downstairs. One of his friends has your katana, and is brandishing it at Asuna in a frightening manner.
In a rage, you run up the stairs, pushing past drunk party goers and spilling drinks. As you reach the balcony at the end of the hall, you see the two preparing to slice Asuna in half.

Upstairs Hall

You can see a main staircase, your door, Other roomates door, Chads door and Upstairs bathroom door here.

* * *

I beg your pardon?

>z
Time passes.

You suddenly hear your dumbass roomate Chad yell from the upstairs balcony "Yo Dudes! Look what I found!"
He's waving Ms. Asuna's body over the balcony while everyone jeers and laughs. They must have grabbed it while you went downstairs. One of his friends has your katana, and is brandishing it at Asuna in a frightening manner.
In a rage, you run up the stairs, pushing past drunk party goers and spilling drinks. As you reach the balcony at the end of the hall, you see the two preparing to slice Asuna in half.

Upstairs Hall
 CHAAAAAAAAAAAAAAAAAAD 

You can see a main staircase, your door, Other roomates door, Chads door and Upstairs bathroom door here.

>z
Time passes.

* * *

>punch chad
You charge forward, and swing your fist with all your might at chads face. Lucky for him, he manages to duck away just in time or he would have been decimated. By the time you recoil your punch,  the guy with your katana grabs you from behind, and Chad punches you in the stomach. With your quick thinking, you realize there's two options, kick the friend in the nuts or try to wriggle free.

>wriggle
As Chad comes in for another punch, you drop low, and try to pull free from the mongrel behind you. Chad wasn't expecting this, and his punch connects with his asshole friend's abs, forcing him to double over. In his pain he loses grip of the katana, dropping it. The katana bounces once on the balcony railing, and flies over the edge. It falls and lands straight in the head of one of the party goers.

* * *

>a.lskjdhf;lkasf
That's not a verb I recognise.

* * *

>down
living room
You enter the living room. There is a kitchen to the east and a bathroom to the south. There are also stairs going to the second floor to the west.

You can see a main staircase, a table, Jen and Josh here.

There is far too many people for this house in the downstairs. You could hear the ruckus they were making from upstairs, but now the music is really pounding your ear drums.

>play vidya
You load up Sakura Agent to try to finish your play through. The story was really getting good when you last left off
You can hear Chad yelling as he slides down the balcony into the living room.

* * *

>z
Time passes.

* * *

>turn up
You must name something more substantial.

>pick up the katana
Probably shouldn't bring the katana out to the party.

>fuck you i do it anyways
That's not a verb I recognise.

>to the north
That's not a verb I recognise.

>go north
You can't go that way.

>go anyways
You can't see any such thing.

>go north east
I only understood you as far as wanting to go north.

>go north west'
I only understood you as far as wanting to go north.

>nw
You can't go that way.

>s
(first opening your door)

>go to sleep
You can't see any such thing.

>sleep
You aren't feeling especially drowsy.

>pick up body pillow
You can't see any such thing.

>burn house down
You can't see any such thing.

>open door
Which do you mean, your door, Other roomates door, Chads door or Upstairs bathroom door?

>look
Upstairs Hall
In the big hallway outside your room, there's already a number of people upstiars chatting. You don't know any of them, are hesitant to strike up a conversation. At the east end of the hallway is the balcony overlooking the living room on the floor below. On the northwest side of the hallway is the door to your bathroom, and on the northeast side is the door back to the sactuary of your room. Southeast and southwest of the hallway are doors to Chad and your other housemate's rooms. At the other end of the hallway there are stairs leading down to the living room.

You can see your door, Other roomates door, Chads door, Upstairs bathroom door, a main staircase and Now the player here.

>punch chad
You charge forward, and swing your fist with all your might at chads face. Lucky for him, he manages to duck away just in time or he would have been decimated. By the time you recoil your punch,  the guy with your katana grabs you from behind, and Chad punches you in the stomach. With your quick thinking, you realize there's two options, kick the friend in the nuts or try to wriggle free.

>kick
(friend)
You launch your hardest heel kick you can straight into the asshole's groin. He doubles over, releasing you and dropping the katana. The katana bounces once on the balcony railing, and flies over the edge. It falls and lands straight in the head of one of the party goers.

>jump
You jump on the spot.

>jump off balcpny
I only understood you as far as wanting to jump.

>jump off balcony
I only understood you as far as wanting to jump.

>commit seppuku
That's not a verb I recognise.

>commit suicide
That's not a verb I recognise.

>die
That's not a verb I recognise.

>conjure a lightning elemental
That's not a verb I recognise.

>eat chad
You can't see any such thing.

>eat
What do you want to eat?

>chad
You can't see any such thing.

>eat
What do you want to eat?

>pizza
You can't see any such thing.

>eat
What do you want to eat?

>dick
You can't see any such thing.

>eat
What do you want to eat?

>ur mom
You can't see any such thing.

>fuck you
That's not a verb I recognise.

>restart
Are you sure you want to restart?

* * *

>restart
Are you sure you want to restart?

>y
9-to-Midnight
An Interactive Fiction by Evan Thomson
Release 1 / Serial number 171207 / Inform 7 build 6M62 (I6/v6.33 lib 6/12N) SD

Your Room
Posters of all your favorite anime cover the walls. In one corner is a bookshelf holding your collection of authentic Japanese Mangas, with action figures covering the top surface.

You can see your door, an Asuna body pillow and a Katana here.

>who am i
That's not a verb I recognise.

>what is my purpose
That's not a verb I recognise.

>examine asuna
You see nothing special about the Asuna body pillow.

>examine ur mom
You can't see any such thing.

>examine katana
it's an authentic Hanzo sword from the early 16th century, folded over 1000 times by master craftsmen until the perfect composition was reached.

>examine bed
You can't see any such thing.

>examine room
You can't see any such thing.

>examine dresser
You can't see any such thing.

>examine me
You are Jeremy, a 3rd year in college. A bit overweight, but your beard is coming in nicely and you dress sharply.

>exmine my butt
That's not a verb I recognise.

>examine door
You see nothing special about your door.

>open door
You open your door.

>leave room
I only understood you as far as wanting to leave.

>leave
But you aren't in anything at the moment.

>south motherfucker
I only understood you as far as wanting to (go) south.

* * *

>look
Upstairs Hall
In the big hallway outside your room, there's already a number of people upstiars chatting. You don't know any of them, are hesitant to strike up a conversation. At the east end of the hallway is the balcony overlooking the living room on the floor below. On the northwest side of the hallway is the door to your bathroom, and on the northeast side is the door back to the sactuary of your room. Southeast and southwest of the hallway are doors to Chad and your other housemate's rooms. At the other end of the hallway there are stairs leading down to the living room.

You can see your door, Other roomates door, Chads door, Upstairs bathroom door, a main staircase and Now the player here.

>open chad door
You can't see any such thing.

>open chad's door
You can't see any such thing.

>open door
Which do you mean, your door, Other roomates door, Chads door or Upstairs bathroom door?

>chads
It seems to be locked.

>break it
Violence isn't the answer to this one.

>fuck chad'
That's not a verb I recognise.

>go downstairs
You can't see any such thing.

>down
There is far too many people for this house in the downstairs. You could hear the ruckus they were making from upstairs, but now the music is really pounding your ear drums.

>look
living room
You enter the living room. There is a kitchen to the east and a bathroom to the south. There are also stairs going to the second floor to the west.

You can see a main staircase, a table, Jen and Josh here.

>ask jen about chad
Yea I don't like him too much either. My friend dated him for a bit, but they broke up "cause he was a douche.

>ask jen about trump
There is no reply.

>ask jen about butts
There is no reply.

>ask jen about other roommate
There is no reply.

>ask jen about jen
Hi! We are in a few of the same classes right? I feel like I recognize you.

>ask jen hi
I didn't understand that sentence.

>ask jen out
I didn't understand that sentence.

>ask jen ona date
I didn't understand that sentence.

>ask jen about party
Its not so bad. I mean, a bunch of frat bros but I know a few others here and it can be fun to watch the apes go through their rudimentary motions.

>i too am an intellectual
I only understood you as far as wanting to take inventory.

>ask jen about her major
There is no reply.

>ask jen about her hobbies
There is no reply.

>ask jen about her opinions on ethanol compared to fossil fuels
There is no reply.

>ask jen baout anime
I didn't understand that sentence.

>ask jen about anime
I've seen a couple. My favorite is One Punch Man, I love that one!

>ask jen about manga]
There is no reply.

>ask jen about manga
There is no reply.

>ask jen about the ancient and noble art of ninjitsu
There is no reply.

>ask jen about katanas
There is no reply.

>ask jen about food
There is no reply.

>ask jen about want sum fuk
There is no reply.

>ask jen about movies
There is no reply.

>ask jen about school
There is no reply.

>kill myself
Violence isn't the answer to this one.

>kill jen
Violence isn't the answer to this one.

>punch jen
Violence isn't the answer to this one.

>do a barrell roll
That's not a verb I recognise.

>do a flip
That's not a verb I recognise.

>nope the fuck out
That's not a verb I recognise.

>look
living room
You enter the living room. There is a kitchen to the east and a bathroom to the south. There are also stairs going to the second floor to the west.

You can see a main staircase, a table, Jen and Josh here.

>e
Kitchen
In the kitchen you find a couple bowls of punch or other presumably alcoholic drinks. There's cups nearby for people to serve themselves There are also cans of beer nearby but beers are so cliche. A few people you've never seen before are hanging out in the kitchen, presumably to be closer to the alcohol.

You can see Punch, Jess and a frat guy here.

>look
Kitchen
In the kitchen you find a couple bowls of punch or other presumably alcoholic drinks. There's cups nearby for people to serve themselves There are also cans of beer nearby but beers are so cliche. A few people you've never seen before are hanging out in the kitchen, presumably to be closer to the alcohol.

You can see Punch, Jess and a frat guy here.

You suddenly hear your dumbass roomate Chad yell from the upstairs balcony "Yo Dudes! Look what I found!"
He's waving Ms. Asuna's body over the balcony while everyone jeers and laughs. They must have grabbed it while you went downstairs. One of his friends has your katana, and is brandishing it at Asuna in a frightening manner.
In a rage, you run up the stairs, pushing past drunk party goers and spilling drinks. As you reach the balcony at the end of the hall, you see the two preparing to slice Asuna in half.

>say stahp
Whom do you want to say that to?

>chad
You can't see any such thing.

>say no
Whom do you want to say that to?

>chad
You can't see any such thing.

>say fuk u
Whom do you want to say that to?

>cahd
You can't see any such thing.

>say stop to chad
You can't see any such thing.

>look
Kitchen
In the kitchen you find a couple bowls of punch or other presumably alcoholic drinks. There's cups nearby for people to serve themselves There are also cans of beer nearby but beers are so cliche. A few people you've never seen before are hanging out in the kitchen, presumably to be closer to the alcohol.

You can see Punch, Jess and a frat guy here.

>scenario
That's not a verb I recognise.

>tackle chad
You charge forward, and swing your fist with all your might at chads face. Lucky for him, he manages to duck away just in time or he would have been decimated. By the time you recoil your punch,  the guy with your katana grabs you from behind, and Chad punches you in the stomach. With your quick thinking, you realize there's two options, kick the friend in the nuts or try to wriggle free.

>wriggle
I didn't understand that sentence.

>wriggle free
As Chad comes in for another punch, you drop low, and try to pull free from the mongrel behind you. Chad wasn't expecting this, and his punch connects with his asshole friend's abs, forcing him to double over. In his pain he loses grip of the katana, dropping it. The katana bounces once on the balcony railing, and flies over the edge. It falls and lands straight in the head of one of the party goers.

>call popo
That's not a verb I recognise.

>call po po
That's not a verb I recognise.

>play vidya
You load up Sakura Agent to try to finish your play through. The story was really getting good when you last left off

>watch anime
You try to watch the latest episode but you can only find the dubbed version, and refuse to watch this westernized garbage. You instead start to rewatch Sword Art Online, probably the greatest anime of all time.

>time
That's not a verb I recognise.

>restart
Are you sure you want to restart?

* * *

>y
9-to-Midnight
An Interactive Fiction by Evan Thomson
Release 1 / Serial number 171207 / Inform 7 build 6M62 (I6/v6.33 lib 6/12N) SD

Your Room
Posters of all your favorite anime cover the walls. In one corner is a bookshelf holding your collection of authentic Japanese Mangas, with action figures covering the top surface.

You can see your door, an Asuna body pillow and a Katana here.

>south
(first opening your door)

>punch
What do you want to punch?

>chad
You charge forward, and swing your fist with all your might at chads face. Lucky for him, he manages to duck away just in time or he would have been decimated. By the time you recoil your punch,  the guy with your katana grabs you from behind, and Chad punches you in the stomach. With your quick thinking, you realize there's two options, kick the friend in the nuts or try to wriggle free.

>restart
Are you sure you want to restart?

* * *

>down
There is far too many people for this house in the downstairs. You could hear the ruckus they were making from upstairs, but now the music is really pounding your ear drums.

>lok
That's not a verb I recognise.

>look
living room
You enter the living room. There is a kitchen to the east and a bathroom to the south. There are also stairs going to the second floor to the west.

You can see a main staircase, a table, Jen and Josh here.

>ask jen party
I didn't understand that sentence.

>ask jen about party
Its not so bad. I mean, a bunch of frat bros but I know a few others here and it can be fun to watch the apes go through their rudimentary motions.

>ask jen about chad
Yea I don't like him too much either. My friend dated him for a bit, but they broke up "cause he was a douche.

>ask jen about dance
There is no reply.

>ask jen about one punch
I'm so hyped for season 3 coming out soon.

>look
living room
You enter the living room. There is a kitchen to the east and a bathroom to the south. There are also stairs going to the second floor to the west.

You can see a main staircase, a table, Jen and Josh here.

>kitchen
That's not a verb I recognise.

>east
Kitchen
In the kitchen you find a couple bowls of punch or other presumably alcoholic drinks. There's cups nearby for people to serve themselves There are also cans of beer nearby but beers are so cliche. A few people you've never seen before are hanging out in the kitchen, presumably to be closer to the alcohol.

You can see Punch, Jess and a frat guy here.

>eat beer
You can't see any such thing.

>eat vodka
You can't see any such thing.

>eat ginger ale
You can't see any such thing.

>eat mountain dew
You can't see any such thing.

>eat doritos
You can't see any such thing.

>eat alcohol
You can't see any such thing.

>eat punch
That's plainly inedible.

>drink punch
You must supply a noun.

>drink drank
You can't see any such thing.

>drink the blood of my enemies like chad that feeble minded ape i cant believe he gets girls and I don't
You can't see any such thing.

* * *

>look
Your Room
Posters of all your favorite anime cover the walls. In one corner is a bookshelf holding your collection of authentic Japanese Mangas, with action figures covering the top surface. Your RGB gaming machine sits on your desk, with mouse and keyboard setup perfectly in front of it. From downstairs you can hear people chattering, and the thumping of some shitty pop music.  Your roomate Chad is throwing another frat party.

You can see your door, an Asuna body pillow and a Katana here.

>s
(first opening your door)

>look
Upstairs Hall
In the big hallway outside your room, there's already a number of people upstiars chatting. You don't know any of them, are hesitant to strike up a conversation. At the east end of the hallway is the balcony overlooking the living room on the floor below. On the northwest side of the hallway is the door to your bathroom, and on the northeast side is the door back to the sanctuary of your room. Southeast and southwest of the hallway are doors to Chad and your other housemate's rooms. At the other end of the hallway there are stairs leading down to the living room.

You can see your door, Other roomates door, Chads door, Upstairs bathroom door, a main staircase and Now the player here.

* * *

>x door
Your door is on the south end of your room, with Sword Art Online poster hanging on it.

>look
Your Room
Posters of all your favorite anime cover the walls. In one corner is a bookshelf holding your collection of authentic Japanese Mangas, with action figures covering the top surface. Your RGB gaming machine sits on your desk, with mouse and keyboard setup perfectly in front of it.  From downstairs you can hear people chattering, and the thumping of some shitty pop music.  Your roomate Chad is throwing another frat party.

You can see your door, an Asuna body pillow and a Katana here.

* * *

>punch chad
That wouldn't be good for roomate relations.

I beg your pardon?

* * *

>punch chad
That wouldn't be good for roomate relations.

>z
That wouldn't be good for roomate relations.

>z
That wouldn't be good for roomate relations.

>s
That wouldn't be good for roomate relations.

* * *

>punch chad
That wouldn't be good for roomate relations.

>tackle chad
He's way bigger than you, it's probably a bad idea.

>kick friend
That's a bit rude.

>wriggle free
There's nothing to wriggle free from.

* * *

>examine pillow
Your (current) waifu. You gaze into her eyes longingly but know now is not the time.

>yay
That's not a verb I recognise.

>use katana
You give your katana a couple of practice swings. While the others are out partying, you study the blade.

>use computer
You sit down at your desk, and turn your computer on. Your desktop pic is the beatiful Asuna. But should you watch the latest episode of "Nanatsu no Taizai: Imashime no Fukkatsu" or play some vidya?

>watch anime
You try to watch the latest episode but you can only find the dubbed version, and refuse to watch this westernized garbage. You instead start to rewatch Sword Art Online, probably the greatest anime of all time.

You can hear Chad yelling as he slides down the balcony into the living room.

>go outside
You can't go that way.

>open door?
You can't see any such thing.

>go south
(first opening your door)

Upstairs Hall
In the big hallway outside your room, there's already a number of people upstiars chatting. You don't know any of them, are hesitant to strike up a conversation. At the east end of the hallway is the balcony overlooking the living room on the floor below. On the northwest side of the hallway is the door to your bathroom, and on the northeast side is the door back to the sanctuary of your room. Southeast and southwest of the hallway are doors to Chad and your other housemate's rooms. At the other end of the hallway there are stairs leading down to the living room.

You can see your door, Other roomates door, Chads door, Upstairs bathroom door and a main staircase here.

>east
You can't go that way.

>northwest
(first opening Upstairs bathroom door)

Upstairs bathroom
You can see Upstairs bathroom door here.

>open door
That's already open.

>go inside
You can't go that way.

>northwest
You can't go that way.

>south
Upstairs Hall
In the big hallway outside your room, there's already a number of people upstiars chatting. You don't know any of them, are hesitant to strike up a conversation. At the east end of the hallway is the balcony overlooking the living room on the floor below. On the northwest side of the hallway is the door to your bathroom, and on the northeast side is the door back to the sanctuary of your room. Southeast and southwest of the hallway are doors to Chad and your other housemate's rooms. At the other end of the hallway there are stairs leading down to the living room.

You can see Upstairs bathroom door, your door, Other roomates door, Chads door and a main staircase here.

>west
You can't go that way.

>north
You can't go that way.

* * *

>east
You can't go that way.

>look
Upstairs Hall
In the big hallway outside your room, there's already a number of people upstiars chatting. You don't know any of them, are hesitant to strike up a conversation. At the east end of the hallway is the balcony overlooking the living room on the floor below. On the northwest side of the hallway is the door to your bathroom, and on the northeast side is the door back to the sanctuary of your room. Southeast and southwest of the hallway are doors to Chad and your other housemate's rooms. At the other end of the hallway there are stairs leading down to the living room.

You can see Upstairs bathroom door, your door, Other roomates door, Chads door and a main staircase here.

>down
living room
You enter the living room. There is a kitchen to the east and a bathroom to the south. There are also stairs going to the second floor to the west.

You can see a main staircase, Chad, a table, Jen and Josh here.

There is far too many people for this house in the downstairs. You could hear the ruckus they were making from upstairs, but now the music is really pounding your ear drums.

>examine josh
You're pretty sure you've seen Josh around school a couple times before. He doesn't seem too bad, maybe he'd be interested in talking about Inuyasha.

>tak to joeh
That's not a verb I recognise.

>talk to josh
That's not a verb I recognise.

>poke josh
That's not a verb I recognise.

>josh
That's not a verb I recognise.

>talk joeh
That's not a verb I recognise.

>examine jen
Jen is one of Chad's friends, and its probably not worth your time talking to her.

>use josh
I didn't understand that sentence.

>ask josh about anime
I watched DBZ when I was a kid, that shit was dope.

I beg your pardon?

>ask joeh about one punch
You can't see any such thing.

>ask josh about One Punch
There is no reply.

>ask jen about One Punch
I'm so hyped for season 3 coming out soon.

>ask jen
What do you want to ask Jen for?

>jen
(Jen first taking Jen)
Jen has better things to do.

>ask jen
What do you want to ask Jen for?

>chad
(Jen first taking Chad)
Jen has better things to do.

>ask jess
You can't see any such thing.

>ask josh
What do you want to ask Josh for?

>chad
(Josh first taking Chad)
Josh has better things to do.

>ask josh
What do you want to ask Josh for?

>school
You can't see any such thing.

>ask josh party
I didn't understand that sentence.

>ask josh about party
I wasn't gonna come, but I though I'd just show up and see whats happening.

>z
Time passes.

>z
Time passes.

You suddenly hear your dumbass roomate Chad yell from the upstairs balcony "Yo Dudes! Look what I found!"
He's waving Ms. Asuna's body over the balcony while everyone jeers and laughs. They must have grabbed it while you went downstairs. One of his friends has your katana, and is brandishing it at Asuna in a frightening manner.
In a rage, you run up the stairs, pushing past drunk party goers and spilling drinks. As you reach the balcony at the end of the hall, you see the two preparing to slice Asuna in half.

Upstairs Hall
 CHAAAAAAAAAAAAAAAAAAD 

You can see a main staircase, Upstairs bathroom door, your door, Other roomates door and Chads door here.

>z
Time passes.

10:36 pm, 10:37 pm.
They slice Asuna in half, and feathers burst out fluttering around the room. Through the mass of feathers you can see the katana fly out of the drunken oaf's hand, fliping above the crowd for a brief moment before falling down directly into the skull of one of the party goers.

>tackle chad
You charge forward, going for a double leg take down. Chad elbows you in the back, causing you to lose your grip and the oaf with the katana grabs you.  While the oaf is subduing you, Chad punches you in the stomach. With your quick thinking, you realize there's two options, kick the friend in the nuts or try to wriggle free.

10:36 pm, 10:38 pm.
They slice Asuna in half, and feathers burst out fluttering around the room. Through the mass of feathers you can see the katana fly out of the drunken oaf's hand, fliping above the crowd for a brief moment before falling down directly into the skull of one of the party goers.

>kick him in the nuts
I didn't understand that sentence.

>kick nuts
I didn't understand that sentence.

>kick
(friend)
You launch your hardest heel kick you can straight into the asshole's groin. He doubles over, releasing you and dropping the katana. The katana bounces once on the balcony railing, and flies over the edge. It falls and lands straight in the head of one of the party goers.

10:36 pm, 10:39 pm.
They slice Asuna in half, and feathers burst out fluttering around the room. Through the mass of feathers you can see the katana fly out of the drunken oaf's hand, fliping above the crowd for a brief moment before falling down directly into the skull of one of the party goers.

* * *

>x body pillow
Your (current) waifu. You gaze into her soft, hazel eyes longingly but know now is not the time.

>x katana
it's an authentic Hanzo sword from the early 16th century, folded over 1000 times by master craftsmen until the perfect composition was reached.

>x door
Your door is on the south end of your room, with Sword Art Online poster hanging on it.

>door
That's not a verb I recognise.

>exit
But you aren't in anything at the moment.

>sout
That's not a verb I recognise.

>s
(first opening your door)

Upstairs Hall
In the big hallway outside your room, there's already a number of people upstiars chatting. You don't know any of them, are hesitant to strike up a conversation. At the east end of the hallway is the balcony overlooking the living room on the floor below. On the northwest side of the hallway is the door to your bathroom, and on the northeast side is the door back to the sanctuary of your room. Southeast and southwest of the hallway are doors to Chad and your other housemate's rooms. At the other end of the hallway there are stairs leading down to the living room.

You can see your door, Other roomates door, Chads door, Upstairs bathroom door and a main staircase here.

>north
You can't go that way.

>n
You can't go that way.

>ne
Your Room
Posters of all your favorite anime cover the walls. In one corner is a bookshelf holding your collection of authentic Japanese Mangas, with action figures covering the top surface. Your RGB gaming machine sits on your desk, with mouse and keyboard setup perfectly in front of it.  From downstairs you can hear people chattering, and the thumping of some shitty pop music.  Your roomate Chad is throwing another frat party.

You can see your door, an Asuna body pillow and a Katana here.

>watch anime
You try to watch the latest episode but you can only find the dubbed version, and refuse to watch this westernized garbage. You instead start to rewatch Sword Art Online, probably the greatest anime of all time.

You can hear Chad yelling as he slides down the balcony into the living room.

>fucking chad
That's not a verb I recognise.

>s
Upstairs Hall
In the big hallway outside your room, there's already a number of people upstiars chatting. You don't know any of them, are hesitant to strike up a conversation. At the east end of the hallway is the balcony overlooking the living room on the floor below. On the northwest side of the hallway is the door to your bathroom, and on the northeast side is the door back to the sanctuary of your room. Southeast and southwest of the hallway are doors to Chad and your other housemate's rooms. At the other end of the hallway there are stairs leading down to the living room.

You can see your door, Other roomates door, Chads door, Upstairs bathroom door and a main staircase here.

>s
You can't go that way.

>sw
(first opening Chads door)
It seems to be locked.